111111111111111
100000V0000C001
100C0000P0M0001
111111000011111
1E00000C0011111
111111111111111
