111111111111
100000E00001
1000C0000001
100000000001
10P000000001
10000C000001
111111111111
