11111111
100000E1
1000C001
10000001
10P00001
10000C01
11111111
